R 800 600

NO ./text/bendy/Wall.xpm
WE ./text/bendy/WallTear.xpm
EA ./text/bendy/Wall.xpm
SO ./text/bendy/Wall.xpm
D ./text/bendy/DoorNoBlurr.xpm

F ./text/walls/blackfloor.xpm
C 0, 0, 0

        1111111111111111111111111
        1000020000110000000000001
        1001000001110000003000001
        100100000008000N000000001
111111111001000031100000000000011
100000500001000001119111111111111
11110000000000011100000010001
11100111111111011101010310001
11400000110101000000000000001
1000000300000001100000010001
10000000000000001101010010201
11020001110101011111010010011
11110111111101011101111000041
11111111 1111111 111111111111