R 800 600

NO ./text/walls/door22.xpm
WE ./text/walls/door22.xpm
EA ./text/walls/door22.xpm
SO ./text/walls/door22.xpm
D ./text/walls/door2.xpm

F ./text/walls/leaves-plant-green-texture.xpm
C 7, 30, 0

        1111111111111111111111111
        1000000000110200000000001
        1001000001110000002000001
        100100000008000N000000001
111111111001003001100200000020011
100000050001000001119111111111111
11110000000000011100000010401
11100111111111011101010010001
11400000110101000000000000001
1000000300000001100000010031
10000000000000001121010010001
11020001110101011111010010011
11110111111101011101111000001
11111111 1111111 111111111111